SCUM=基础设置
MaxAllowedAnimalsInWorld=最大动物数量 [最高: 100]
MaxAllowedBirdsInworld=最大鸟数量 [最高: 100]
MaxAllowedZombiesInWorld=最大僵尸数量 [最高: 100]
MaxAllowedWildPawnsInWorld=最大野外僵尸数量 [最高: 100]
MaxAllowedExteriorPawnsInWorld=室外僵尸数量 [最高: 100]
MaxAllowedInteriorPawnsInWorld=室内丧尸数量 [最高: 100]
MaxAllowedSentriesInWorld=高达生成 [0无高达 -1有高达]
MaxAllowedVehiclesInWorld=最大车辆数量 [最高64]
ExteriorPawnAmountModifier=室外生成僵尸倍率 [最大5.0倍]
InteriorPawnAmountModifier=室内生存僵尸倍率 [最大5.0倍]
WildPawnAmountModifier=野外生成僵尸倍率 [最大5.0倍]
ExteriorPawnSpawningCheckTimeInSeconds=室外僵尸生成检查时间 [单位:秒]
InteriorPawnSpawningCheckTimeInSeconds=室内僵尸生成检查时间 [同上]
WildPawnSpawningCheckTimeInSeconds=野外僵尸生成检查时间 [同上]
ExteriorPawnSpawningProbability=室外生成僵尸概率 [最大100.0]
InteriorPawnSpawningProbability=室内生成僵尸概率 [最大100.0]
ExteriorSpawnerGroupCooldownTime=室外僵尸刷新冷却时间 [单位:秒]
InteriorSpawnerGroupCooldownTime=室内僵尸刷新冷却时间 [单位:秒]
StartTimeOfTheDay=一天开始的时间 [7.0等于早上7点]
TimeOfTheDaySpeed=游戏内时间速度 [1等于现实中6小时 1:6 ]
DarknessIntensityMultiplier=游戏内亮度 [不建议修改]
stormProbabilityMultiplier=暴风雨天气概率
AllowSectorRespawn=允许区域复活 [1为可用，0不可用]
AllowShelterRespawn=允许在床/帐篷复活 [同上]
AllowSquadmateRespawn=允许小队重生
SCUM.RespawnSettings=复活设置
RandomLocationPrice=随机复活声望消耗
SectorLocationPrice=区域复活声望消耗
ShelterLocationPrice=在家复活声望消耗
SquadLocationPrice=在队友处复活声望消耗
RandomInitialTime=随机复活初始时间
SectorInitialTime=区域复活初始时间
ShelterInitialTime=在家复活初始时间
SquadInitialTime=在队友处复活初始时间
RandomCooldownTime=随机复活冷却时间
SectorCooldownTime=区域复活冷却时间
ShelterCooldownTime=在家复活冷却时间
SquadCooldownTime=在队友处复活冷却时间
RandomCooldownResetMultiplier=随机复活冷却重置速度
SectorCooldownResetMultiplier=区域复活冷却重置速度
ShelterCooldownResetMultiplier=在家复活冷却重置速度
SquadCooldownResetMultiplier=在队友处复活冷却重置速度
SCUM.ItemSpawning=物品生成设置
SpawnerProbabilityMultiplier=物资倍率
ExamineSpawnerProbabilityMultiplier=物资刷新(刷掉)时间
ExamineSpawnerExpirationTimeMultiplier=检查再生器过期时间倍率
SpawnerGroupsExpirationTimeInMinutesMultiplier=生成器组失效时间分钟倍率
SCUM.WorldEvents=世界事件设置
TimeBetweenEventsMin=空投最小时间间隔 [单位:分钟]
TimeBetweenEventsMax=空投最大时间间隔 [单位:分钟]
CargoDropFallDelay=空投标识出现到生成间隔 [单位:秒]
CargoDropFallDuration=空投掉落时间 [单位:秒]
CargoDropSelfDestructTime=空投落地到爆炸的时间 [单位:秒]
SCUM.Sentries=高达设置
SentryDamageMultiplier=高达伤害倍率
SCUM.Zombies=僵尸设置
ZombieDamageMultiplier=僵尸伤害倍率
SCUM.BaseBuilding=基本建筑设置
UseMapBasedBuildingRestriction=基于地图的建筑限制
SCUM.Vehicles=载具设置
FuelDrainFromEngineMultiplier=发动机燃油排放倍率
BatteryDrainFromEngineMultiplier=发动机蓄电池消耗速度
BatteryDrainFromDevicesMultiplier=设备电池消耗速度
BatteryDrainFromInactivityMultiplier=非活动状态下电池电量耗尽速度
BatteryChargeWithAlternatorMultiplier=交流发电机为电池充电速度
BatteryChargeWithDynamoMultiplier=发电机为电池充电速度